Вот критерии, которых ты должен придерживаться при переводе (как мы с тобой договорились):

Лаконичность и читабельность по-русски, без кальки с арабского, но без потери смысла.

Ничего не пропускать: сохранять все предложения, смысловые связки и важные уточнения (в т.ч. причины, перечисления, выводы).

Даты не опускать (ум. … г. х. и т.п.) и не "сглаживать" хронологию.

Убирать арабские вставки в русском тексте (названия/термины — по-русски/транслитом), если ты не просишь оставить арабский.

Единая терминология:

«асхаб аль-вуджух» → «ученые внутримазхабных мнений» (и дальше всегда так).

«вуджух» в тексте → «внутримазхабные мнения».

Имена и титулы:

если человек назван имамом — в русском тоже писать "имам";

после "имам Аш-Шафии" всегда добавлять "(да будет доволен им Аллах)";

по твоей текущей установке: после упоминания учёных добавлять "(да помилует его Аллах)", и не ставить арабские формулы.

«Шафиитский мазхаб» писать с заглавной буквы.

Если в тексте есть цитаты/аяты — давать точные ссылки (сура:аят) в таком формате [ Сура Корова, 23 аят; ]

Термины, связанные с высказываниями имама Аш-Шафии (да будет доволен им Аллах)

الأظهر — аль-Азхар [ наиболее сильное из мнений Имама ]

المشهور — аль-Машхур [ наиболее сильное из мнений Имама; противоположное слабое/неизвестное ]

القديم — аль-Кадим [ старое мнение Имама ]

الجديد — аль-Джадид [ новое мнение Имама ]

في قول — фи кьавлин [ есть мнение ]

في قول قديم — фи кьавлин кадим [ есть старое мнение ]

في قول كذا — фи кьавли каза [ есть такое-то мнение ]

قولان — кьавляни [ два мнения ]

أقوال — акьвалю [ много мнений ]

Термины, связанные со сторонниками внутримазхабных мнений

أصحاب الوجوه — асхаб аль-вуджух [ ученые внутримазхабных мнений ]

وجه / وجوه — ваджх / вуджух [ внутримазхабное мнение / внутримазхабные мнения ]

الأصح — аль-Асахх [ более предпочтительное из внутримазхабных мнений; альтернативное тоже может быть сильным ]

الصحيح — ас-Сахих [ более предпочтительное из внутримазхабных мнений; альтернативное слабое ]

في وجه — фи ваджхи [ есть внутримазхабное мнение (обычно слабое) ]

وجهان — аль-Ваджахани [ два внутримазхабных мнения ]

الأوجه — аль-Авджух [ внутримазхабные мнения (больше двух) ]

قيل — кьиля [ сказано (обычно слабое мнение) ]

أحسن الوجهين — ахсан аль-ваджхайн [ лучшее из двух внутримазхабных мнений ]

Составные термины

النص — ан-Насс [ прямой текст Имама ]

المنصوص — аль-Мансус [ текстуально фиксированное / текстово подтверждённое ]

الأصح المنصوص — аль-Асахх аль-Мансус [ более предпочтительное, подтверждённое прямым текстом ]

Термин «аль-Мазхаб» и связанные с путями передачи

المذهب — аль-Мазхаб [ преобладающее решение в мазхабе ]

الطريقان — ат-тарикан [ два пути передачи ]

الطرق — ат-турук [ пути передачи ]

Термины слабости/аномальности

شاذ — шазз [ аномальное мнение ]

واهٍ — вахи [ очень слабое мнение ]

الخفي — аль-Хафи [ скрытое мнение (противоположное «аль-Машхур») ]

الظاهر — аз-Захир [ явное мнение (противоположное «аль-Азхар») ]

Прочие термины, которые обсуждали

القول المخرج — аль-кьавль аль-мухрадж [ производное/выведенное мнение ]

قلت — культу [ я сказал ]

والله أعلم — ва-Ллаху а'лям [ Аллах знает лучше ]

التفصيل — ат-тафсиль [ детализация в вопросе ]

махрам [ человек с которым запрещен брак ]

вуду — малое ритуальное омовение

истинджа — очищение после справления нужды

вадью — беловатые густые выделения после мочеиспускания

хуфф — специфические носки [ хуффы ]

муким — пребывающий на месте [ не путник ]

гусль — большое ритуальное купание [ гусль ]

джанабат — большое ритуальное осквернение [ джанаба ]

عَوْرَة (аврат) → «части тела, обязательные к прикрытию [ аврат ]»

جماعة (джама'ат) →
в контексте намаза: «коллективная молитва [ джамаат ]»
вне контекста намаза: «группа людей [ джамаат ]»

الصلاة جامعة → «Ас-саляту джами'а» [ Молитва — собирающая людей ]

أذّن / أذان ، أقام / إقامة: по-русски писать «оглашают», а не «произносят».

الإقامة → «икама» [ икама ]

قد قامت الصلاة → «молитва уже началась» [ кад камати-с-салят ]

الإدراج → «слитное и быстрое оглашение (икамы)» [ идрадж ]

الترتيل → «размеренное, неторопливое оглашение (азана)» [ тарти́ль ]

الترجيع → «возвратное произнесение свидетельств» [ тарджи' ]

الحيعلتان → «хай'аля» [ хай'аля ] (в контексте: «две хай'али» — две формулы «хай'аля…» в азане)

التثويب → «фраза "молитва лучше сна" (в утреннем азане)» [ тасвиб ]

الصلاة خير من النوم → «молитва лучше сна» [ ас-саляту хайрун мина-н-навм ]

التمييز → «сознательность» [ то есть способность понимать и действовать самостоятельно: сам есть и пить, и сам выполнять очищение после справления нужды [ истинджа ]. ]

اجتهاد → «исследование» [ иджтихад ]

تكبيرة الإحرام → вступительный такбир [ такбират аль-ихрам ]

الافتراش → ифтираш — сидение на стопе левой ноги [ ифтираш ]

التورك → таваррук — сидение на левой ягодице, прижатой к земле [ таваррук ]

التربع → тараббу' — сидение, скрестив ноги перед собой [ тараббу' ]

دعاء الافتتاح → вступительная мольба [ ду'а аль-ифтитах ]

التعوذ → прибегание к защите Аллаха [ та'ауввуз ]

المسبوق → опоздавший (к коллективной молитве) [ масбук ].

البسملة → Басмала [ «Бисмилляхи-р-Рахмани-р-Рахим» ].

المأموم → следующий за имамом [ ма'мум ].

الصبح → утренняя молитва [ субх ]

الظهر → полуденная молитва [ зухр ]

العصر → послеполуденная молитва [ 'аср ]

المغرب → закатная молитва [ магриб ]

العشاء → ночная молитва [ 'иша ]

سجود التلاوة → земной поклон при чтении аята земного поклона [ суджуд тилява ].